File=Datei
Undo=Rückgängig
Cancel=Abbrechen
Select All=Alles Auswählen
AMainMenu=AHauptmenü
NatsuLion Help=NatsuLion Hilfe
Advanced=Erweitert
Make Text Bigger=Schrift vergrößern
Show All=Alle anzeigen
Account Information=Benutzerkonto
Font Size=Schriftgröße
no Username=kein Benutzername
Password:=Kennwort:
Dark=Dunkel
Check Grammar With Spelling=Grammatik während der Eingabe prüfen
Window Transparency:=Transparenz:
Make Text Smaller=Schrift verkleinern
Cut=Ausschneiden
Shown at top=Oben anzeigen
Reply=Antworten
Close=Schließen
Send message with Control + Enter=Nachricht mit Eingabe + Enter absenden
Copy=Kopieren
Quit NatsuLion=NatsuLion beenden
Text Cell=Textbereich
Use Growl notifications=Growl Benachrichtigungen verwenden
Edit window transparency manually=Transparenz manuell einstellen
New message:=Neueste Nachricht:
Check Spelling While Typing=Rechtschreibung während der Eingabe prüfen
Minimize=Im Dock ablegen
Make Text Normal Size=Schrift in Normalgröße
Speech=Sprachausgabe
Services=Dienste
Show Spelling…=Rechtschreibung anzeigen…
Mark All As Read=Alles als gelesen markieren
About NatsuLion=Über NatsuLion
Basic=Basis
Zoom=Zoomen
Redo=Wiederholen
Show Conversation=Unterhaltung anzeigen
Box=Box
Message=Nachricht
Customize Toolbar…=Toolbar anpassen…
OtherViews=AndereAnsichten
Start Speaking=Sprache starten
Select Message View=Nachrichtenanzeige auswählen
Preferences…=Einstellungen…
Change=Ändern
Summarize when more than:=Zusammenfassen wenn mehr als:
Show detail status on the status bar=Details in der Statusleiste anzeigen
Check Spelling=Rechtschreibung prüfen
Shown at bottom=Unten anzeigen
Hide NatsuLion=NatsuLion ausblenden
Paste=Einfügen
Appearance=Erscheinungsbild
Username:=Username:
Done=Erledigt
Raise window when new message arrives=Fenster bei neuer Nachricht einblenden
Make Selected Tweet Favorite=Gewählten Tweet als Favorit markieren
Growl=Growl
Hide Others=Andere ausblenden
Refresh=Neu laden
Delete=Löschen
Spelling and Grammar=Rechtschreibung und Grammatik
Help=Hilfe
Light=Hell
Autoscroll when new message arrives=automatisch zu neuester Nachricht scrollen
Increase transparency while deactivated=Fenster durchsichtig wenn inaktiv
User ID:=Benutzername:
Bring All to Front=Alle nach vorne bringen
Show Toolbar=Toolbar anzeigen
Use POST method to get timeline=POST verwenden um Time Line zu laden
NatsuLion=NatsuLion
Check for updates...=Auf Updates prüfen...
Stop Speaking=Sprache stoppen
Edit=Bearbeiten
Color Scheme:=Farbschema:
Find=Suchen
Apply=Anwenden
Refresh Interval (sec):=Erneut laden (Sek.):
Window=Fenster
View=Ansicht
Thank you for choosing NatsuLion!=Danke, dass Sie NatsuLion verwenden!
Exit=Beenden
Password:=Kennwort:
Please Tell me your Twitter account information.=Bitte geben Sie Ihre Twitter Account Informationen ein.
Start Twittering=Lostwittern
Username:=Username:
NatsuLion=NatsuLion
Set Adium status with posted message=Adium Status mit gesendeter Nachricht setzen
Paste iTunes Track Name=Aktuellen iTunes Titel einfügen
