Applicar=Applicar
Salir de NatsuLion=Salir de NatsuLion
nada=nada
Completo=Completo
Message=Mensaje
AMainMenu=AMainMenu
Summarize when more than:=Número de mensaje:
Paste=Pegar
Increase transparency while deactivated=Hacer tranparente cuando inactivo
Spelling and Grammar=Ortografía
Shown at bottom=Mostrar abajo
Check Spelling While Typing=Comprobar ortografía mientras se escribe
Show All=Mostrar todos
Delete=Eliminar
Use POST method to get timeline=Usar POST por grabar la cronología
Edit window transparency manually=Editar transparencia de ventana
Refresh Interval (sec):=Intervalo de refrescar (sec):
Cut=Cortar
Set Adium status with posted message=Usar mensaje como estado en Adium
New message:=Mensajes nuevos:
Hide NatsuLion=Ocultar de NatsuLion
Select Message View=Selectar un visualización
NatsuLion Help=Ayuda NatsuLion
Cancel=Cancelar
Use Growl notifications=Usar notificación de Growl
Autoscroll when new message arrives=Autodesplazar cuando se reciben mensajes nuevos
Help=Ayuda
Copy=Copiar
Send message with Control + Enter=Enviar con las teclas Ctrl y Enter
Start Speaking=Inciar locución
Minimize=Minimizar
Show Toolbar=Mostrar barra de herramientas
Show detail status on the status bar=Mostrar informacíon en la barra de estado
Bring All to Front=Traer todo al frente
Account Information=Cuenta
Reply=Responder
Make Text Smaller=Más pequeño
Zoom=Zoom
Close=Cerrar ventana
Password:=Contraseña:
Font Size=Tamaño de letra
Light=Claro
Advanced=Avansado
Mark All As Read=Todo deseado
Redo=Rehacer
Appearance=Apariencia
View=Visualización
Check for updates...=Comprobar actualizaciones...
Raise window when new message arrives=Mostrar ventana cuando se reciben mensajes nuevos
File=Archivo
Window=Ventana
Refresh=Actualizar
User ID:=Nombre de usario:
Stop Speaking=Detener locución
Change=Cargar
About NatsuLion=Acerca de NatsuLion
Growl=Growl
Make Selected Tweet Favorite=Marcar como favorito
Shown at top=Mostrar arriba
Speech=Texto hablado
Find=Buscar
Hide Others=Ocultar otros
Customize Toolbar…=Personalizar barra de herramientas…
Edit=Edición
Select All=Seleccionar todo
Basic=Básico
%{value1}@=%{value1}@
Check Spelling=Comprobar el documento ahora
Repost=Reponer
Paste iTunes Track Name=Pegar pista de iTunes
NatsuLion=NatsuLion
Undo=Deshacer
Close=Cerrar
Show Spelling…=Mostrar ortografía y gramática
Show Conversation=Mostrar conversaciónes
Mark All As Read=Tamaño real
Preferences…=Preferencias...
Dark=Oscuro
Color Scheme:=Tema de color:
Window Transparency:=Transparencia:
Services=Servicios
Make Text Bigger=Más grande
Check Grammar With Spelling=Comprobar gramática con la ortografía
Thank you for choosing NatsuLion!=Bienvenido a NatsuLion!
Please Tell me your Twitter account information.=Entre su información de cuenta, por favor.
Username:=Nombre de usario:
Password:=Contraseña:
Start Twittering=Comensar
Exit=Acabar
