AMainMenu=AMainMenu
About NatsuLion=夏ライオンについて
Account Information=アカウント
Advanced=詳細
Appearance=外観
Apply=適用
Ascending=昇順
Autoscroll when new message arrives=自動的にスクロールして新着メッセージを表示
Basic=基本
Box=Box
Bring All to Front=すべてを手前に移動
Cancel=キャンセル
Change=変更
Check Grammar With Spelling=スペルと一緒に文法をチェック
Check Spelling While Typing=入力中にスペルチェック
Check Spelling=スペルを確認
Check for updates...=アップデートを確認...
Close=閉じる
Color Scheme:=カラースキーム:
Copy=コピー
Customize Toolbar…=ツールバーをカスタマイズ…
Cut=カット
Dark=ダーク
Delete=削除
Descending=降順
Done=完了
Edit window transparency manually=透過度を自分で設定する
Edit=編集
Exit=終了
File=ファイル
Find=検索
Font Size=フォントサイズ
Growl=Growl
Help=ヘルプ
Hide NatsuLion=夏ライオンを隠す
Hide Others=ほかを隠す
Increase transparency while deactivated=非アクティブ時に透明化して隠れる
Light=ライト
Make Selected Tweet Favorite=Favorite に入れる
Make Text Bigger=大きく
Make Text Normal Size=標準サイズ
Make Text Smaller=小さく
Mark All As Read=全て既読にする
Message=メッセージ
Minimize=しまう
NatsuLion Help=夏ライオンヘルプ
NatsuLion=夏ライオン
Next=次へ
OtherViews=OtherViews
Password:=パスワード:
Paste=ペースト
Please Tell me your Twitter account information.=アカウント情報を入力してください
Preferences…=環境設定…
Quit NatsuLion=夏ライオンを終了
Raise window when new message arrives=新着時にウインドウを最前面に表示
Redo=やり直す
Refresh Interval (sec):=更新間隔 (秒):
Refresh=更新
Reply=返信
Select All=すべてを選択
Select Message View=ビューを選択
Send message with Control + Enter=Ctrl + Enter キーで送信する
Services=サービス
Show All=すべてを表示
Show Spelling…=スペルと文法を表示
Show Toolbar=ツールバーを表示
Show statistics on the status bar (experimental)=統計情報をステータスバーに表示する
Speech=スピーチ
Spelling and Grammar=スペル
Start Speaking=読み上げを開始
Stop Speaking=読み上げを停止
Summarize when more than:=メッセージをまとめる個数:
Text Cell=Text Cell
Thank you for choosing NatsuLion!=夏ライオンへようこそ!
Timeline sort order:=ソート順:
Undo=取り消す
Use Growl notifications=Growl 通知を使う
Use POST method to get timeline=タイムラインの取得に POST を用いる
User ID:=ユーザ名:
Username:=ユーザ名:
View=ビュー
Window Transparency:=透過度:
Window=ウインドウ
Zoom=拡大/縮小
no Username=未設定
%{value1}@=%{value1}@
Start Twittering=はじめる
